NO ./textures/north_wall.xpm
SO ./textures/south_wall.xpm
WE ./textures/west_wall.xpm
EA ./textures/east_wall.xpm

F 220,100,0
C 135,206,235

1111111111111111111111111111111111111111
1000000000000000000000000000000000000001
1000000000000000000000000000000000000001
1000011111111000000000000000000000000001
1000010000000000000000000000000000000001
10000100N0000000000000000000000000000001
1000010000000000000000000000000000000001
1000011111111000000000000000000000000001
1000000000000000000000000001111111100001
1000000000000000100000000000000000000001
1000000000000000010000000000000000000001
1000000000000000001000000000000000000001
1000000000000000000100000000000000000001
1000000000000000000010000000000000000001
1000000000000000000100000000000000000001
1000000000000000001000000000000000000001
1000000000000000010000000000000000000001
1000000000000000100000000000000000000001
1000000000000000100000000000000000000001
1000000000000000100000000000000000000001
1000000000000000100000000000000000000001
1000000000000000000000000000000000000001
1000000111111111111111000000000000000001
1000000000000000000011111111111111100001
1000000000000000000000000000000000000001
1000000000000000000000000000000000000001
1000000000000000000000000000000000000001
1000000000000000000000000000000000000001
1000000000000000000000000000000000000001
1111111111111111111111111111111111111111